..........
.####.....
..........
...###....
..........
.....##...
..........
.##.......
..........
......#...